{
  "rooms": [
    ["room1", 5, 0, 0, 7],
    ["room2", 5, 7, 0, 11],
    ["room3", 8, 8, 5, 10]
  ],
  "map_array" : [
    [
      [1, 1, 1, 1, 1, 1, 1, 1, 1, 1, 1, 1],
      [1, 1, 1, 1, 1, 1, 1, 1, 1, 1, 1, 1],
      [1, 8, 8, 12, 12, 12, 1, 1, 1, 1, 1, 1],
      [1, 8, 8, 9, 13, 11, 1, 1, 1, 1, 1, 1],
      [1, 8, 8, 9, 13, 11, 1, 1, 1, 1, 1, 1],
      [1, 8, 8, 10, 10, 10, 1, 1, 1, 1, 1, 1],
      [0, 0, 0, 0, 0, 0, 0, 0, 1, 1, 1, 0],
      [0, 0, 0, 0, 0, 0, 0, 0, 1, 1, 1, 0],
      [0, 0, 0, 0, 0, 0, 0, 0, 1, 1, 1, 0]
    ],
    [
      [2, 2, 2, 2, 2, 2, 2, 2, 2, 2, 2, 2],
      [2, 0, 0, 0, 0, 0, 0, 2, 0, 0, 0, 2],
      [2, 0, 0, 0, 0, 0, 0, 0, 0, 0, 0, 2],
      [2, 0, 0, 0, 3, 0, 0, 2, 0, 0, 0, 2],
      [2, 0, 0, 0, 0, 0, 0, 2, 0, 0, 0, 2],
      [2, 2, 2, 2, 2, 2, 2, 2, 2, 0, 2, 2],
      [0, 0, 0, 0, 0, 0, 0, 0, 2, 0, 2, 0],
      [0, 0, 0, 0, 0, 0, 0, 0, 2, 0, 2, 0],
      [0, 0, 0, 0, 0, 0, 0, 0, 2, 2, 2, 0]
    ],
    [
      [2, 2, 2, 2, 2, 2, 2, 2, 2, 2, 2, 2],
      [2, 0, 5, 0, 0, 0, 0, 2, 0, 0, 0, 2],
      [2, 4, 0, 0, 0, 0, 0, 0, 0, 0, 0, 2],
      [2, 0, 0, 0, 0, 0, 0, 6, 0, 0, 0, 2],
      [2, 0, 0, 0, 0, 0, 0, 6, 0, 0, 0, 2],
      [2, 7, 7, 7, 7, 7, 7, 6, 2, 0, 2, 2],
      [0, 0, 0, 0, 0, 0, 0, 0, 2, 0, 2, 0],
      [0, 0, 0, 0, 0, 0, 0, 0, 2, 0, 2, 0],
      [0, 0, 0, 0, 0, 0, 0, 0, 2, 2, 2, 0]
    ]
  ]
}
