{
  "rooms": [
    ["basketball_court", 6, 1, 1, 9],
    ["mud_pool", 13, 1, 9, 7],
    ["tables", 5, 11, 2, 14],
    ["street", 16, 0, 0, 16]
  ],
  "map_array" : [
    [
      [1,  1,  1,  1,  1,  1,  1,  1,  1,  1,  1,  1,  1,  1,  1,  1,  1],
      [1,  8,  8,  8,  8,  8,  8,  8,  8,  8,  8,  8,  8,  8,  8,  8,  1],
      [1, 13, 12, 12, 12, 12, 12, 12, 12, 13,  8, 16, 16, 16, 16,  8,  1],
      [1, 13,  9, 13, 13, 13, 13, 13, 11, 13,  8, 16, 16, 16, 16,  8,  1],
      [1, 13,  9, 13, 13, 13, 13, 13, 11, 13, 16, 16, 16, 16, 16,  8,  1],
      [1, 13,  9, 13, 13, 13, 13, 13, 11, 13,  8, 16, 16, 16, 16,  8,  1],
      [1, 13,  9, 13, 13, 13, 13, 13, 11, 13,  8,  8, 16,  8,  8,  8,  1],
      [1, 13, 10, 10, 10, 10, 10, 10, 10, 13,  8,  8, 16,  8,  8,  8,  1],
      [1,  8,  8,  8, 16,  8,  8,  8,  8,  8,  8,  8, 16,  8,  8,  8,  1],
      [1,  8,  8,  8, 16,  8,  8,  8,  8,  8,  8,  8, 16,  8,  8,  8,  1],
      [1, 17, 17, 17, 17, 17, 17, 17,  8,  8,  8,  8, 16,  8,  8,  8,  1],
      [1, 17, 17, 17, 17, 17, 17, 17,  8,  8,  8,  8, 16,  8,  8,  8,  1],
      [1, 17, 17, 17, 17, 17, 17, 17, 16, 16, 16, 16, 16, 16, 16,  8,  1],
      [1, 17, 17, 17, 17, 17, 17, 17,  8,  8,  8,  8,  8,  8, 16,  8,  1],
      [1, 17, 17, 17, 17, 17, 17, 17,  8,  8,  8,  8,  8,  8, 16,  8,  1],
      [1,  8,  8,  8,  8,  8,  8,  8,  8,  8,  8,  8,  8,  8, 16,  8,  1],
      [1,  1,  1,  1,  1,  1,  1,  1,  1,  1,  1,  1,  1,  1,  1,  1,  1]
    ],
    [
      [2,  2,  2,  2,  2,  2,  2,  2,  2,  2,  2,  2,  2,  2,  2,  2,  2],
      [2,  0,  0,  0,  0,  0,  0,  0,  0,  0,  0,  0,  0,  0,  0,  0,  2],
      [2,  0,  0,  0,  0,  0,  0,  0,  0,  0,  0,  0,  0, 15,  0,  0,  2],
      [2,  0,  0,  18,  3,  0,  0,  0,  0,  0,  0,  0,  0, 14, 15,  0,  2],
      [2,  0,  0,  0,  0,  0,  0,  0,  0,  0,  0,  0,  0,  0,  0,  0,  2],
      [2,  0,  0,  0,  0,  0,  0,  0,  0,  0,  0,  0,  0,  0,  0,  0,  2],
      [2,  0,  0,  0,  0,  0,  0,  0,  0,  0,  0,  0,  0,  0,  0,  0,  2],
      [2,  0,  0,  0,  0,  0,  0,  0,  0,  0,  0,  0,  0,  0,  0,  0,  2],
      [2,  0,  0,  0,  0,  0,  0,  0,  0,  0,  0,  0,  0,  0,  0,  0,  2],
      [2,  0,  0,  0,  0,  0,  0,  0,  0,  0,  0,  0,  0,  0,  0,  0,  2],
      [2,  0,  0,  0,  0,  0,  0,  0,  0,  0,  0,  0,  0,  0,  0,  0,  2],
      [2,  0,  0,  0,  0,  0,  0,  0,  0,  0,  0,  0,  0,  0,  0,  0,  2],
      [2,  0,  0,  0,  0,  0,  0,  0,  0,  0,  0,  0,  0,  0,  0,  0,  2],
      [2,  0,  0,  0,  0,  0,  0,  0,  0,  0,  0,  0,  0,  0,  0,  0,  2],
      [2,  0,  0,  0,  0,  0,  0,  0,  0,  0,  0,  0,  0,  0,  0,  0,  2],
      [2,  0,  0,  0,  0,  0,  0,  0,  0,  0,  0,  0,  0,  0,  0,  0,  2],
      [2,  2,  2,  2,  2,  2,  2,  2,  2,  2,  2,  2,  2,  2,  2,  2,  2]
    ],
    [
      [6,  7,  7,  7,  7,  7,  7,  7,  7,  7,  7,  7,  7,  7,  7,  7,  6],
      [6,  0,  0,  0,  0,  0,  0,  0,  0,  0,  0,  0,  0,  0,  0,  0,  6],
      [6,  0,  0,  0,  0,  0,  0,  0,  0,  0,  0,  0,  0,  0,  0,  0,  6],
      [6,  4,  0,  0,  0,  0,  0,  0,  0,  0,  0,  0,  0,  0,  0,  0,  6],
      [6,  0,  0,  0,  0,  0,  0,  0,  0,  0,  0,  0,  0,  0,  0,  0,  6],
      [6,  4,  0,  0,  0,  0,  0,  0,  0,  0,  0,  0,  0,  0,  0,  0,  6],
      [6,  0,  0,  0,  0,  0,  0,  0,  0,  0,  0,  0,  0,  0,  0,  0,  6],
      [6,  0,  0,  0,  0,  0,  0,  0,  0,  0,  0,  0,  0,  0,  0,  0,  6],
      [6,  0,  0,  0,  0,  0,  0,  0,  0,  0,  0,  0,  0,  0,  0,  0,  6],
      [6,  0,  0,  0,  0,  0,  0,  0,  0,  0,  0,  0,  0,  0,  0,  0,  6],
      [6,  0,  0,  0,  0,  0,  0,  0,  0,  0,  0,  0,  0,  0,  0,  0,  6],
      [6,  0,  0,  0,  0,  0,  0,  0,  0,  0,  0,  0,  0,  0,  0,  0,  6],
      [6,  0,  0,  0,  0,  0,  0,  0,  0,  0,  0,  0,  0,  0,  0,  0,  6],
      [6,  0,  0,  0,  0,  0,  0,  0,  0,  0,  0,  0,  0,  0,  0,  0,  6],
      [6,  0,  0,  0,  0,  0,  0,  0,  0,  0,  0,  0,  0,  0,  0,  0,  6],
      [6,  0,  0,  0,  0,  0,  0,  0,  0,  0,  0,  0,  0,  0,  0,  0,  6],
      [6,  7,  7,  7,  7,  7,  7,  7,  7,  7,  7,  7,  7,  7,  7,  7,  6]
    ]
  ]
}
