{
  "rooms": [
    ["basketball_court", 6, 1, 1, 9],
    ["street", 11, 0, 0, 16]
  ],
  "map_array" : [
    [
      [1,  1,  1,  1,  1,  1,  1,  1,  1,  1,  1,  1,  1,  1,  1,  1,  1],
      [1, 13, 12, 12, 12, 12, 12, 12, 12, 13,  8,  8,  8,  8,  8,  8,  1],
      [1, 13,  9, 13, 13, 13, 13, 13, 11, 13,  8,  8,  8,  8,  8,  8,  1],
      [1, 13,  9, 13, 13, 13, 13, 13, 11, 13,  8,  8,  8,  8,  8,  8,  1],
      [1, 13,  9, 13, 13, 13, 13, 13, 11, 13,  8,  8,  8,  8,  8,  8,  1],
      [1, 13,  9, 13, 13, 13, 13, 13, 11, 13,  8,  8,  8,  8,  8,  8,  1],
      [1, 13, 10, 10, 10, 10, 10, 10, 10, 13,  8,  8,  8,  8,  8,  8,  1],
      [1,  8,  8,  8,  8,  8,  8,  8,  8,  8,  8,  8,  8,  8,  8,  8,  1],
      [1,  8,  8,  8,  8,  8,  8,  8,  8,  8,  8,  8,  8,  8,  8,  8,  1],
      [1,  8,  8,  8,  8,  8,  8,  8,  8,  8,  8,  8,  8,  8,  8,  8,  1],
      [1,  8,  8,  8,  8,  8,  8,  8,  8,  8,  8,  8,  8,  8,  8,  8,  1],
      [1,  1,  1,  1,  1,  1,  1,  1,  1,  1,  1,  1,  1,  1,  1,  1,  1]
    ],
    [
      [2,  2,  2,  2,  2,  2,  2,  2,  2,  2,  2,  2,  2,  2,  2,  2,  2],
      [2,  0,  0,  0,  0,  0,  0,  0,  0,  0,  0,  0,  0,  0,  0,  0,  2],
      [2,  0,  0,  0,  0,  0,  0,  0,  0,  0,  0,  0, 15,  0,  0,  0,  2],
      [2,  0,  0,  0,  0,  0,  0,  0,  0,  0,  0,  0, 14, 15,  0,  0,  2],
      [2,  0,  0,  0,  0,  0,  0,  0,  0,  0,  0,  0,  0,  0,  0,  0,  2],
      [2,  0,  0,  0,  0,  0,  0,  0,  0,  0,  0,  0,  0,  0,  0,  0,  2],
      [2,  0,  0,  0,  0,  0,  0,  0,  0,  0,  0,  0,  0,  0,  0,  0,  2],
      [2,  0,  0,  0,  0,  0,  0,  0,  0,  0,  0,  0,  0,  0,  0,  0,  2],
      [2,  0,  0,  0,  0,  0,  0,  0,  0,  0,  0,  0,  0,  0,  0,  0,  2],
      [2,  0,  0,  0,  0,  0,  0,  0,  0,  0,  0,  0,  0,  0,  0,  0,  2],
      [2,  0,  0,  0,  0,  0,  0,  0,  0,  0,  0,  0,  0,  0,  0,  0,  2],
      [2,  2,  2,  2,  2,  2,  2,  2,  2,  2,  2,  2,  2,  2,  2,  2,  2]
    ],
    [
      [6,  7,  7,  7,  7,  7,  7,  7,  7,  7,  7,  7,  7,  7,  7,  7,  6],
      [6,  0,  0,  0,  0,  0,  0,  0,  0,  0,  0,  0,  0,  0,  0,  0,  6],
      [6,  4,  0,  0,  0,  0,  0,  0,  0,  0,  0,  0,  0,  0,  0,  0,  6],
      [6,  0,  0,  0,  0,  0,  0,  0,  0,  0,  0,  0,  0,  0,  0,  0,  6],
      [6,  4,  0,  0,  0,  0,  0,  0,  0,  0,  0,  0,  0,  0,  0,  0,  6],
      [6,  0,  0,  0,  0,  0,  0,  0,  0,  0,  0,  0,  0,  0,  0,  0,  6],
      [6,  0,  0,  0,  0,  0,  0,  0,  0,  0,  0,  0,  0,  0,  0,  0,  6],
      [6,  0,  0,  0,  0,  0,  0,  0,  0,  0,  0,  0,  0,  0,  0,  0,  6],
      [6,  0,  0,  0,  0,  0,  0,  0,  0,  0,  0,  0,  0,  0,  0,  0,  6],
      [6,  0,  0,  0,  0,  0,  0,  0,  0,  0,  0,  0,  0,  0,  0,  0,  6],
      [6,  0,  0,  0,  0,  0,  0,  0,  0,  0,  0,  0,  0,  0,  0,  0,  6],
      [6,  7,  7,  7,  7,  7,  7,  7,  7,  7,  7,  7,  7,  7,  7,  7,  6]
    ]
  ]
}
